NO ./textures/brick.png
SO ./textures/gold0.png
WE ./textures/gravel.png
EA ./textures/bark.png


F 220,100,0
C 123      , 1059,68

 1111
10001
10E001
11111  