NO ./textures/bark.png
F 220,100,0


SO ./textures/gravel.png

C 225,30,0
WE ./textures/gold0.png
EA ./textures/brick.png



 1111
10001
10E001
11111  