EA ./textures/bark.png

NO ./textures/brick.png

F 13, 15, 17
WE ./textures/gravel.png

C 100, 150, 200
SO ./textures/gold0.png

 1111
10001
10E001
11111  