NO ./textures/matrix.png
SO ./textures/matrix.png
WE ./textures/matrix.png
EA ./textures/matrix.png

F 220,100,0
C 225,30,0

        1111111111111111111111111
        1000000000110000000000001
        1011000001110000000000001
        100100000000000E0000000001101
1111111110110000011100000000000000001
1000000000110000011101111101111111111
11110111111111011100000010001
11110111111111011101010010001111
11000000110101011100000000000001
1000000000000000110000001000111
10000000000000000001010010001
1100000111010101111101111000111
11110111 1110101 101111010001
11111111 1111111 111111111110